%%%%%%%%%%%%%%%%%%%%%%%%%%%%%%%%%%%
%                    %            %
% %%%%%%%% %%% %%%%% % %%%%%%%%%  %
% %      %     % P %   % %        %
% %% %%% %%%%%%% % %%%%% % %%%%%%%%
% %%  %  %     %                  %
%   % %%%%% %%%% %%%%% % % %%%% % %
%%% %     %  %%  %%%%  % %      % %
%%% %% %% %% %% % % % %%%%% % % % %
%    %  %  %  % % %       %     % %
% %% %% %% %% %%% %%%%%%%%% %%% % %
% %% %  %%      % %          %    %
%    % %%  % %%%% % %%% %%%% % % %%
% %% % %% %% %      % %    % % %  %
% %  % %%  %   %%%% % % % %% % %% %
% % %%  %% %%%%%%     % %       % %
% % %%%           %%%     %%% % % %
% %    %%%%%%%%%% %   %%% %%    % %
% %% %          % %%%        %%%% %
%  % %%%%%%%%%%     %%% %%%       %
%% %          %%%%%         %%%%% %
%% %% %%% %%%     %%%%%%%%% %     %
%% %  %   % %%%%% %           %% %%
%% % %% % % %   % % %%%%% %%%% % %%
%% %  % % % % % % %          % %  %
%  %% %     % % % %%% %%%%%%%% %% %
% %%  %%% %%% % % %%%           % %
% %                   %% %%% %% % %
% % %%%%%%%%%% %%% %% %% %%     % %
% %  % %%% %%%        %%    % %%% %
% %% %      %% % % %% %% %% % %   %
%    % %%%%              %  %   % %
% % %%      % %%%% % %%% % %% % % %
% %    %%%%%%      %     % %  % % %
% %%%%%%      %%%% %%%%%%% % %% %%%
%.       %%%%%%            %      %
%%%%%%%%%%%%%%%%%%%%%%%%%%%%%%%%%%%
