%%%%%%%%%%%%%%%%%%%%%%%%%%%%%%%%%%%
%.% %       %    %  %      %%%%   %
%   %%%  %%%%%%%    % %%%%    % % %
%%%            % %  % %%%%%%%   % %
%  %%%%% %%% % % %  % %       % % %
%      % %   % %  % % %%%%%%% % % %
% % %%   % % % %%   %       %   % %
% %%%%%% % %%%   % %% %% %% %%%   %
% %  %%%     %%% % %%     % % %   %
%  %   %%%%% %   % %%%%%%%  % % % %
%%   %         %         % %    % %
%%% %% %%%%% % %%% %%%%%%% % % %  %
%%       %%  %   % %P        % %%%%
%  %% %%%    %% %  %  %%%% %    % %
% %% %    %%%%% % %%%%%%   %  % % %
% %% % %%%%%         %%%%%%  %%   %
%    %       %%%%% %            % %
%%%%%%%%%%%%%%%%%%%%%%%%%%%%%%%%%%%