%%%%%%%%%%%%%%%%%%%%%%%%%%%%%%%%%%%
% % %       %    %  %      %%%%  P%
%   %%%  %%%%%%%    % %%%%    % % %
%%%            % %  % %%%%%%%   % %
%  %%%%% %%% % % %  % %       % % %
%      % %   % %  % % %%%%%%% % % %
% % %%   % % % %%   %       %   % %
% %%%%%% % %%%   % %% %% %% %%%   %
% %  %%%     %%% % %%     % % %   %
%  %   %%%%% %   % %%%%%%%  % % % %
%%   %         %         % %    % %
%%% %% %%%%% % %%% %%%%%%% % % %  %
%%       %%  %   % %         % %%%%
%  %% %%%    %% %  %  %%%% %    % %
% %% %    %%%%% % %%%%%%   %  % % %
% %% % %%%%%         %%%%%%  %%   %
%.   %       %%%%% %            % %
%%%%%%%%%%%%%%%%%%%%%%%%%%%%%%%%%%%
