%%%%%%%
%   P %
%% %% %
%     % 
%%%%% %
%.    %
%%%%%%%
