%%%%%%%
%  .  %
%% %% %
%     %
%%%%% %
%P    %
%%%%%%%
