%%%%%%%
%  .  %
%% %% %
%     % 
%%%%  %
%P    %
%%%%%%%